

                             ###   ###   ###   ###  
                             ###   ###   ###   ###
                             #####################
                             ##################### 
                             ##     /\   /\     ##
                              ##   |__| |__|   ##
                                ##           ##
                                ##         ##
                                ##         ##
                                ##         ##
                                ##   |■|   ##   
###################################  |■|  ##################################
###################################  |■|  ##################################
##                      |■|■|■|      |■|                                  ##
##                        ##                  ##                          ##     
##     Catacombs          ##    Thrown Room   ##        Star-Lift         ##    
##                        ##                  ##       Observatory        ##
##                        ##                  ##                          ##          
##                        ##                  ##                          ##
###################################     ####################################
###################################     ####################################
##                    ##                           ##                     ##
##                    ##                           ##                     ##
##   Whispering                   Ballroom                Haunted         ##
##     Library        ##                           ##     Gallery         ##
##                    ##                           ##                     ##
###################################     ####################################
###################################     ####################################
##                    ##                           ##                     ##
##   Living Gardens   ##                           ##     Cursed Well     ##
##                    ##                           ##                     ##	  
##      ####                                                 ####         ## 
##     #    #                    Courtyard                  #    #        ## 
##    #      #                                             #      #       ##   
##     #    #         ##             X             ##       #    #        ##
##      ####          ##                           ##        ####         ##
##                    ##                           ##                     ## 
########################                           #########################


